0  0  0  0  0  0  0  0  0  0  0  0  0  0  0  0  
0  64 0  0  0  0  0  0  0  0  0  0  64 64 64 0  
0  0  5  4  4  4  4  4  4  4  4  4  4  6  64 0  
0  0  1  0  0  0  0  0  0  0  0  0  64 2  64 0  
0  0  1  0  0  0  0  0  0  0  0  0  0  2  0  0  
0  0  1  0  0  5  4  4  4  4  6  0  0  2  0  0  
0  0  1  0  0  1  0  0  0  64 2  0  0  2  0  0  
0  0  1  0  0  1  0  0  0  0  2  0  0  2  0  0  
0  0  1  0  0  1  0  0  0  0  2  0  0  2  0  0  
0  0  1  64 0  1  0  0  0  0  2  0  0  2  64 0  
0  0  1  64 0  1  64 32 8  8 10  0  0  2  0  0  
0  0  1  64 0  1  0  0  0  0  0  0  0  2  0  0  
0  0  1  0  0  1  0  0  0  0  0  0  0  2  0  0  
0  0  1  0  0  9  8  8  8  8  8  8  8  10 0  0  
0  0  1  0  0  0  0  0  0  0  0  0  0  0  0  0  
0  0  17 0  0  0  0  0  0  0  0  0  0  0  0  0  
