0  0  0  0  0  0  0  0  0  0  0  0  0  0  0  0  
0  0  0  0  0  0  0  0  0  0  0  0  0  0  0  0  
20 4  4  4  4  4  4  4  4  4  4  4  4  6  0  0  
0  0  0  0  0  0  64 64 64 0  0  0  0  2  0  0   
0  64 64 0  0  0  64 64 64 0  0  0  0  2  0  0  
0  64 10 8  8  8  8  8  8  8  8  8  8  10 0  0   
0  64 2  0  0  0  0  0  0  0  0  0  0  0  0  0  
0  64 2  0  0  0  0  0  0  0  0  0  0  0  0  0 
0  64 6  4  4  4  4  4  4  4  4  4  4  6  0  0 
0  64 64 0  0  0  0  0  0  0  0  0  64 2  0  0  
0  0  0  0  0  0  0  0  0  0  0  0  0  2  64 0   
0  0  10 8  8  8  8  8  8  8  8  8  8  10 0  0 
0  0  2  64 0  0  0  0  0  0  0  0  0  0  0  0 
0  0  2  0  0  0  0  0  0  0  0  0  0  0  0  0   
0  0  32 0  0  0  0  0  0  0  0  0  0  0  0  0  
0  0  0  0  0  0  0  0  0  0  0  0  0  0  0  0  
